##########       ######
#      XO#       #    #
#   P  ###       #    #
#        #       #    #
#####    #########    ################
# O##    X                         #O#
#  ##                                #
#    XX                              #
#     # O#############################
####                    #
   #                    #
   #                    #
   ######################